# # # # # # # # # # # # # #
#                       & #
#                         #
#                         #
#                         #
#                         #
#                         #
#                         #
#                         #
#                         #
#                         #
#                         #
#                         #
#                         #
#                         # ?
#                         #
#                         #
#                         #
#                         #
#                         #
#                         #
#                         #
#                         #
#                         #
#                         #
#                         #
#                         #
#                         #
#                         #
#                         #
#                         #
#                         #
#                         #
#                         #
#                         #
#                         #
#                         #
#                         #
#                         #
#                         #
#                         #
#                         #
#                         #
#                         #
#                         #
#                         #
#                         #
#                         #
#                         #
#                         #
#                         #
#                         # ?
#                         #
#                         #
#                         #
#                         #
#                         #
#                         #
#                         #
#                         #
#                         #
#                         #
#                         #
#                         #
#                         #
#                         #
#                         #
#                         #
#                         #
#                         #
#                         #
#                         #
#                         #
#                         #
#                         #
#                         #
#                         #
#                         #
#                         #
#                         #
#                         #
#                         #
#                         #
#                         #
#                         #
#                         #
#                         #
#                         #
#                         #
#                         #
#                         #
#                         #
#                         #
#                         #
#                         #
#                         #
#                         #
#                         #
#                         #
#                         #
#                         #
#                         #
#                         # ?
#                         #
#                         #
#                         #
#                         #
#                         #
#                         #
#                         #
#                         #
#                         #
#                         #
#                         #
#                         #
#                         #
#                         #
#                         #
#                         #
#                         #
#                         #
#                         #
#                         #
#                         #
#                         #
#                         #
#                         #
#                         #
#                         #
#                         #
#                         #
#                         #
#                         #
#                         #
#                         #
#                         #
#                         #
#                         # ?
#                         #
#                         #
#                         #
#                         #
#                         #
#                         #
#                         #
#                         #
#                         #
#                         #
#                         #
#                         #
#                         #
#                         #
#                         #
#                         #
#                         #
#                         #
#                         #
#                         #
#                         #
#                         #
#                         #
#                         #
#                         #
#                         #
#                         #
#                         #
#                         #
#                         #
#                         #
#                         #
#                         #
#                         #
#                         #
#                         #
#                         #
#                         #
#                         #
#                         #
#                         # ?
#                         #
#                         #
#                         #
#                         #
#                         #
#                         #
#                         #
#                         #
#                         #
#                         #
#                         #
#                         #
#                         #
#                         #
#                         #
#                         #
#                         # ?
#                         #
#                         #
#                         #
#                         #
#                         #
#                         #
#                         #
#                         #
#                         #
#                         #
#                         #
#                         #
#                         #
#                         #
#                         #
#                         # ?
#                         #
#                         #
#                         #
#                         #
#                         #
#                         #
#                         #
#                         #
#                         #
#                         #
#                         #
#                         #
#                         #
# $                       #
# # # # # # # # # # # # # #

** Info **
# - Wall
$ - Player Start
^ - Bird
& - End Goal
? - Next Layer (Inclusive)

Keep in mind that the map, though in this example looks horizontal, is primarily vertical.